111111111111111111111
100000000000P0C000E01
10000000000000C000E01
10000000000000C000E01
10000000000000C000E01
10000000000000C000E01
10000000000000C000E01
10000000000000C000E01
111111111111111111111
